###############
#S#   #       #
# # ### ### # #
# #   #   # # #
# ### # ### # #
#     #   # # #
# ### ### #   #
# #   #   ### #
# # ### # # # #
# #   # # # # #
# # # # #   # #
# # # # ##### #
#   #   #F    #
###############
